アポロ	アポロ	① (Project) Apollo (lat:).<br />② Apollo (god of Greek and Roman mythology) (lat:).	 アポロ１１号[あぽろじゅういちごう]が 月面着陸[げつめんちゃくりく]に 成功[せいこう]したというニュースが 入[はい]った。 A report came in that Apollo 11 succeeded in landing on the moon.<br /> 同日[どうじつ]に アポロ１１号[あぽろじゅういちごう]が 月面着陸[げつめんちゃくりく]に 成功[せいこう]した。 On the same day, Apollo 11 succeeded in landing on the moon's surface.
アポロ１１号	アポロじゅういちごう	Apollo 11.	
アポロン	アポロン	Apollo (gre: Apollon).	
アポロン的	アポロンてき	Apollonian.	
アポロ計画	アポロけいかく	Apollo Project.	 アポロ計画[あぽろけいかく]は 宇宙[うちゅう] に関[にかん]する 我々[われわれ]の 知識[ちしき]を 大[おお]いに 増[ま]した。 The Apollo program greatly advanced our knowledge of space.
アポロ的	アポロてき	Apollonian.	
アポロ薄羽白蝶	アポロうすばしろちょう	parnassian butterfly.	
アポ酵素	アポこうそ	apoenzyme.	
天	あま	sky.	 彼[かれ]は 天[てん]を 仰[あお]いだ。 He looked up at the sky.<br /> 神[かみ]は 創造者[そうぞうしゃ]です。 天[てん]も 地[ち]も 人[ひと]も、 神[かみ] 以外[いがい]は 全[すべ]て 被造物[ひぞうぶつ]です。 God is the creator. Heaven and Earth and people and everything apart from God are created.<br /> 天[てん]にも 昇[のぼ]るような 気持[きも]ちです。 I'm so happy, I feel like I could fly.<br /> 縁組[えんぐみ]は 天[てん]でなされる。 Marriage is made in heaven.<br /> 返事[へんじ]を 待[ま]つアリスに 向[む]けられたのは 突然[とつぜん]の 咆哮[ほうこう]。それは 耳[みみ]を 貫[つらぬ]かんばかりに 鋭[するど]く、 天[てん]に 届[とど]かんばかりに 大[おお]きく 響[ひび]くものでした。 What Alice, waiting for a reply, was faced with was a sudden howl. It was a resounding noise, sharp as to burst her ear drums, loud as to reach unto the heavens.<br /> 父[ちち]はいつも「 天[てん]は 自[みずか]ら 助[たす]くる 者[しゃ]を 助[たす]く」と 言[い]っていました。 My father always said that heaven helps those who help themselves.<br /> 富士山[ふじさん]は 天[てん] 高[たか]くそびえている。 Mt. Fuji soars heavenward.<br /> 不運[ふうん]にもＡＬＳにかかってしまったことは 別[べつ]として、 私[わたし]は、 他[た]のほとんどすべての 天[てん]で 幸運[こううん]であった。 Apart from being unlucky enough to get ALS, I have been fortunate in almost every other respect.
アマービレ	アマービレ	amabile (music).	
アマエビ	アマエビ	northern shrimp (Pandalus borealis); sweet shrimp; northern pink prawn; red shrimp; Maine shrimp.	
アマオブネガイ	アマオブネガイ	ox-palate nerite (Nerita albicilla); blotched nerite.	
アマガエル	アマガエル	tree frog (esp. the Japanese tree frog, Hyla japonica).	
アマガエルモドキ科	アマガエルモドキか	Centrolenidae; family of frogs.	
アマガエル科	アマガエルか	Hylidae; frog family.	
アマガサヘビ	アマガサヘビ	krait (esp. the Taiwanese banded krait, Bungarus multicinctus).	
アマゴ	アマゴ	land-locked variety of red-spotted masu trout (Oncorhynchus masou ishikawae); amago.	
アマサギ	アマサギ	cattle egret (Bubulcus ibis).	
アマシイラ科	アマシイラか	Luvaridae; family containing one extant species of perciform fish similar to a surgeonfish.	
アマシイラ属	アマシイラぞく	Luvarus (sole genus of perciform fish in the family Luvaridae whose only member is the luvar).	
アマゾーン	アマゾーン	① the Amazon river.<br />② Amazon (woman of Greek mythology).	
アマゾニス	アマゾニス	Amazons.	
アマゾネス	アマゾネス	Amazons.	
アマゾン	アマゾン	① the Amazon river.<br />② Amazon (woman of Greek mythology).	 彼[かれ]はアマゾンのジャングルを 探検[たんけん]した。 He explored the Amazon jungle.<br />アマゾンのジャングルやニューギニア 島[とう]には、いわゆる 原始的[げんしてき]な 文化[ぶんか]があり、ヨーロッパやアジアやアフリカにはいわゆる 進歩[しんぽ]した 文化[ぶんか]がある。しかし、このいずれの 文化[ぶんか]の 言語[げんご]も 同[おな]じように 進歩[しんぽ]しており、 複雑[ふくざつ]なのである。 There are so-called primitive cultures in the jungles of the Amazon and on the island of New Guinea, and there are so-called advanced cultures in Europe, Asia, and Africa, but the languages of these cultures are all equally advanced and complex.
アマゾンカワイルカ	アマゾンカワイルカ	Amazon river dolphin (Inia geoffrensis).	
アマゾンテンジクネズミ	アマゾンテンジクネズミ	shiny guinea pig (Cavia fulgida).	
アマゾンドットコム	アマゾンドットコム	Amazon.com.	
アマゾン川	アマゾンがわ	Amazon River.	 アマゾン川[あまぞんがわ]は 延々[えんえん]と 北[きた]ブラジルを 流[なが]れている。 The Amazon River meanders through northern Brazil.<br /> アマゾン川[あまぞんがわ]は、ナイル 川[がわ]に 次[つ]いで 世界[せかい]で 二番目[にばんめ]に 長[なが]い 川[かわ]だ。 The Amazon is the second longest river in the world after the Nile.<br /> アマゾン川[あまぞんがわ]には 多[おお]くの 支流[しりゅう]がある。 The Amazon is fed by a large number of tributaries.
アマゾン天竺鼠	アマゾンてんじくねずみ	shiny guinea pig (Cavia fulgida).	
アマダイ	アマダイ	tilefish (Branchiostegus spp.); blanquillo; horse-head fish.	
アマチャヅル	アマチャヅル	jiaogulan (species of herbaceous vine; Gynostemma pentaphyllum).	
アマチュア	アマチュア	amateur.	 私[わたし]のおじはアマチュアのクリケット 選手[せんしゅ]です。 My uncle is an amateur cricket player.<br /> 普通[ふつう]、アマチュアでは250ヤード 飛[と]べばすごい 飛距離[ひきょり]だと 言[い]われます。 Normally you'd call 250 yards a great distance for an amateur.<br /> 今年[ことし]も、アマチュア 音楽家[おんがくか]の 定期[ていき] 演奏会[えんそうかい]が 頻繁[ひんぱん]に 開催[かいさい]される。 This year too there are many regular concerts for amateur musicians being held.<br /> 彼[かれ]はアマチュアにすぎない。 He is just an amateur.<br />ここで 明確[めいかく]にしなければならない 点[てん]は、スポーツにおいてアマチュアとプロフェッショナルの 境界線[きょうかいせん]が 消失[しょうしつ]しつつあるということだ。 The point we must clarify here is that the lines between amateur and professional in sport are beginning to disappear.<br />あなたはプロだが 私[わたし]はアマチュアだ。 You are a professional, but I am an amateur.
アマチュア・カメラマン	アマチュア・カメラマン	amateur photographer.	
アマチュア・バンド	アマチュア・バンド	amateur bands.	
アマチュア・マラソン	アマチュア・マラソン	amateur marathon; fun run.	
アマチュアカメラマン	アマチュアカメラマン	amateur photographer.	
アマチュアバンド	アマチュアバンド	amateur bands.	
アマチュアマラソン	アマチュアマラソン	amateur marathon; fun run.	
アマチュアリズム	アマチュアリズム	amateurism.	
アマチュア無線	アマチュアむせん	amateur radio.	
アマチュア無線局	アマチュアむせんきょく	amateur radio station.	
アマツバメ	アマツバメ	① swift (any bird of family Apodidae).<br />② fork-tailed swift (Apus pacificus).	
アマトリチャーナ	アマトリチャーナ	amatriciana (ita:).	
アマナ	アマナ	Tulipa edulis (species of tulip with an edible bulb).	
アマビリスモミ	アマビリスモミ	Pacific silver fir (Abies amabilis).	
アマビリス樅	アマビリスもみ	Pacific silver fir (Abies amabilis).	
アマミスズメダイ	アマミスズメダイ	stout chromis (Chromis chrysura).	
アマミノクロウサギ	アマミノクロウサギ	Amami rabbit (Pentalagus furnessi); Ryukyu rabbit.	
アマミハナサキガエル	アマミハナサキガエル	Amami tip-nosed frog (Odorrana amamiensis).	
アマモ	アマモ	eelgrass (Zostera marina).	
アマランス	アマランス	amaranth.	
アマリリス	アマリリス	amaryllis.	
アマルガム	アマルガム	amalgam.	
アマルナ時代	アマルナじだい	Amarna period (of Egyptian history).	
アマルナ文書	アマルナぶんしょ	Amarna letters (archive of Egyptian correspondence, recorded on clay tablets).	
アマレット	アマレット	amaretto (ita:).	
アマン	アマン	lover (fre: amant, amante).	
アマンド	アマンド	almond (fre: amande).	
アマ相撲	アマずもう	(sumo) amateur sumo.	
網	あみ	① net; netting.<br />② web.	 彼[かれ]は 法律[ほうりつ]の 網[あみ]にかかった。 He was caught in the clutches of the law.<br /> 彼[かれ]は 網[あみ]を 張[は]った。 He fixed the net.<br /> 彼女[かのじょ]は 網[あみ]を 張[は]らないで 綱渡[つなわた]りに 挑[いど]んだ。 She dared to walk the tightrope without a net.<br /> 日本全国[にほんぜんこく]に 鉄道[てつどう]が 網の目[あみのめ]のようにできている。 A network of railroads spreads all over Japan.<br /> 中国[ちゅうごく]のフットボールの 試合[しあい]では、 選手[せんしゅ] 達[たち]は 足[あし]と 胴体[どうたい]を 使[つか]い、 手[て]は 使[つか]っていませんでした。そしてゴールは 絹[きぬ]でできた 網[あみ]にある 穴[あな]でした。 In the Chinese football game in which the players used their feet and bodies - but never their hands - the goal was a hole in a net made from silk.<br /> 網[あみ]がスクリューに 絡[から]まった。 The net got entangled in the propeller.<br /> 少年[しょうねん]はその 鳥[とり]を 網[あみ]で 捕[つか]まえた。 The boy captured the bird with a net.<br /> 私[わたし]は 網[あみ]を 手[て]から 放[はな]した。 I let go of the rope.
アミーガ	アミーガ	Amiga.	
アミーバ	アミーバ	amoeba.	
アミール	アミール	amir (ara:).	
アミア	アミア	bowfin (Amia calva) (lat: Amia); mudfish.	
アミアイゴ	アミアイゴ	little spinefoot (Siganus spinus, species of Indo-West Pacific rabbitfish); black spinefoot; black trevally; blue-spotted trevally; spiny rabbitfish.	
アミカス・キューリー	アミカス・キューリー	amicus curiae; friend of the court.	
アミカス・キュリィ	アミカス・キュリィ	amicus curiae; friend of the court.	
アミカス・キュリエ	アミカス・キュリエ	amicus curiae; friend of the court.	
アミグダリン	アミグダリン	amygdalin.	
アミセチン	アミセチン	amicetin.	
アミチョウチョウウオ	アミチョウチョウウオ	latticed butterflyfish (Chaetodon rafflesii, species found in the Indo-Pacific).	
アミティ	アミティ	amity.	
網戸	あみど	window screen; insect screen; mosquito screen; screen; screen door.	